░░░█░░░███████░█████░
░░░░░░░░████░░░█████░
█░░░░░░░████░░░░████░
█░░░░░░░████░░░░░███░
█░░░░░░░████░░░░░███░
██░░░░░██████░░░░███░
█████░███████░░░░███░
██████████░████████░░
██████████░░██████░░░
█████░░░░█░░░████░░░░
██░░░░░░░█░░░████░░░░
██░░░░░░░██░░░███░░░░
███████████░░░░██░░░░
████████████░░░███░░░
██████████████░████░░
███░████████████████░
█░░░██████████░█░░██░
█░░░█████░██░░░░░░██░
█░░░░███████░░░░░░░█░
████░░░░█████░░░█░░█░
░░░░░░░░░░░░░░░░░░░░░
